F 220,100,0
C 225,30,0

      1111111       11111
      1S00001       100001111
    110000001       110000001
    100000001       100000001
    100000001       100000001
    111000001       100000011
       100001111111110000111
       1000000000000000001
        10000000000000001
         100000000000001
          1000000000001
           10000000001
            100000001
             1000001
              10001
               111

