NO textures/maps/map1/NO.png
SO textures/maps/map1/SO.png
WE textures/maps/map1/WE.png
EA textures/maps/map1/EA.png

F 96,52,18
C 22,68,104

111111111111111111111111111111111111111111111111111111111111111111111111111111
110000000000001000010000000000000000000000000000100000000000000000000010000011
110000000000001000010000000000000000000000000000100000000000000000000010000011
110000000000111000010000000000000000000000000000111000000000000000000010000011
110000000000000000010001111111111111110000000000100001000000000000000000000011
111111111100001000010001000000000000000000000000111111000000000000000011111111
110000000000001000000001000000000000010000000000000000000000000000000000000011
110000000000001000000001000000000000010000000000000000000000000000000000000011
110000000000001000000001000000000000010000000000000000000000000000000000000011
111111111111111111111111000000111111111111111000011111111001111111111100000011
                       11000011            11000000000000000000000001100000011
                        111111             11000000000000000000000001100000011
                                           11000000000000000000000001111000011111111111111
                                           11000000000000000000000001100000000000010000011
                                           11000000000000000000000001100000000000010000011
                                           11000000000000000000000001100000000000000000011
                                           11000000000000000000000001100000000000010000011
                                           11000000000000000000000001100000000000010000011
                                           11000000000000000000000001111111111000011111111
                                           11000000000000000000000001100000001000010000011
                                           11000000000000000000000001100000000000000000011
                                           11000000000000000000000001100000001000010000011
                                           11000000000000000000000001111111111000011111111
                                           11000000000000000000000001100000001000010000011
                                           11000000000000000000000001100000000000000000011
                                           11000000000000000000000001100000001000010000011
                                           11000000000000000000000001111111111111111111111
                                           11000000000000N000000000011
                                           110000000000000000000000011
                                           111111111111111111111111111