F 220,100,0
C 225,30,0

       111111       11111
      1S00001       1000001
	110000001       010000001
    100000001		100000001
	100000001       100000001
	  1000001       10000001
	   1000011111111100001
	   1000000000000000001
	    10000000000000001
		 100000000000001
		  1000000000001
		   10000000001
		    100000001
		     1000001
		      10001
		       111




