F 220,100,0
C 225,30,0

       111111
      1N00001
	110000000
    111111111